..................................................
#................................@@...............
#7...............................@@..............#
###..............................@@...........0..#
##################################################
##################################################
##################################################