####################################################################################################
####################################################################################################
####################################################################################################
####################################################################################################
####################################################################################################
####################################################################################################
####################################################################################################
##########.....@@@....@@@@@.........@@@@....@@@@@@@@@...@@@@....@......@@@@@@@....##################
#########.....@@@@........@@@@@@@......@....@@@@@@......@@@@@.......@@@@.........###################
#############.@@@@@@@@@@@@@@@@@@...@@@.....@...@.@...@@@......@@@....@.@@@@@.7.@@.##################
#############@@@@@@#################################################################################
#############@@@@@@#################################################################################
#############@@@@@@#################################################################################
###############@@@@#################################################################################
###############@@....................@@.........@@@@@@@@@@@@@...............@@@.####################
###############@@....@@@@@@@@@@@@..................................@@@@.........@@@@################
################@.......@@..........@@@@@@@@.........@@@@.......................@@@@@@##############
###############################################################################@@@@@@@@#############
###############################################################################@@@@@@@##############
###############################################################################@@@@@@@@#############
###############################################################################@@@@@@@##############
########################.......@@.....@@@@@@@@@@............@@@@.....................###############
####################@@@........................@@@@@@@.........@@@@@@@...@@@@........###############
###################.....0....@@@@@@....@@.........@@@@@@@@@@@@@...............@@@.##################
####################################################################################################
####################################################################################################
####################################################################################################
####################################################################################################
####################################################################################################
####################################################################################################
####################################################################################################
####################################################################################################