####################################################################################################
####################################################################################################
####################################################################################################
####################################################################################################
####################################################################################################
####################################################################################################
####################################################################################################
####################################################################################################
############@@@@@....................@@.....................................@@@.####################
##############@@@..................................................@@@@.........@@@@################
################@.......@@...........@@@@@@@.........@@@@.......................@@@@@@##############
###############@@@@@@@###########################################################@@@@@@#############
###############@@@@@@@@@@####################################################@@@@@@@@@##############
###################@@@@@.......@@...........................@@@@.................@@@################
####################@@.........................@@@@@@@...................@@@@...@@@#################
#####################.7................@@.....................................@...##################
########################.......@@...........................@@@@................####################
#########################......................@@@@@@@...................@@@@..#####################
##########################.............@@....................................#######################
####################################################################################################
####################################################################################################
####################################################################################################
####################################################################################################
####################################################################################################
####################################################################################################
####################################################################################################
####################################################################################################