####################################################################################################
####################################################################################################
####################################################################################################
##################....@@@@@.........@@@@@@@@@@@@@@@@@...@@@@....@......@@@@@@@....##################
##############@@@@........@@@@@@@......@@@@@@@@@@@@@@...@@@@@.......@@@@.........###################
#############@@@@@@@@@....@@@@.....@@@.....@...@.@...@@@......@@@....@.@@@@@.7.@@.##################
###########@@@@@@@##################################################################################
############@@@@@....................@@.....................................@@@.####################
##############@@@..................................................@@@@.........@@@@################
################@.......@@...........................@@@@.......................@@@@@@##############
###############################################################################@@@@@@@@#############
###############################################################################@@@@@@@##############
########################.......@@...........................@@@@.....................###############
####################@@@........................@@@@@@@...................@@@@......0.###############
###################.....0..............@@.....................................@@@.##################
####################################################################################################
####################################################################################################
####################################################################################################
####################################################################################################