####################################################################################################
####################################################################################################
####################################################################################################
##################....@@@@@.........@@@@@@@@@@@@@@@@@...@@@@....@......@@@@@@@....##################
##############@@@@........@@@@@@@......@@@@@@@@@@@@@@...@@@@@.......@@@@.........###################
#############@@@@@@@@@....@@@@.....@@@.....@...@.@...@@@......@@@....@.@@@@@...@@.##################
###########@@@@@@@##################################################################################
############@@@@@....................@@.....................................@@@.####################
##############@@@..................................................@@@@.........@@@@################
################@.......@@...........................@@@@.......................@@@@@@##############
###############################################################################@@@@@@@@#############
###############################################################################@@@@@@@##############
########################.......@@...........................@@@@....................################
####################@@@........................@@@@@@@...................@@@@.......################
###################.....0..............@@.....................................@@@.##################
####################################################################################################
####################################################################################################
####################################################################################################
####################################################################################################