####################################################################################################
####################################################################################################
####################################################################################################
####################################################################################################
####################################################################################################
####################################################################################################
####################################################################################################
##########.....@@@....@@@@@.........@@@@....@@@@@@@@@...@@@@....@......@@@@@@@....##################
#########.....@@@@........@@@@@@@......@................@@@@@.......@@@@.........###################
#############.@@@@@@@@@@@@@@@@@@...@@@.....@...@.@...@@@......@@@....@.@@@@@.7.@@.##################
#############@@@@@@#################################################################################
###############@@@@#################################################################################
###############@@....................@@.....................................@@@.####################
###############@@..................................................@@@@.........@@@@################
################@.......@@..........@@@@@@@@.........@@@@.......................@@@@@@##############
###############################################################################@@@@@@@@#############
###############################################################################@@@@@@@##############
########################.......@@...........................@@@@.....................###############
####################@@@........................@@@@@@@...................@@@@........###############
###################.....0..............@@.....................................@@@.##################
####################################################################################################
####################################################################################################
####################################################################################################
####################################################################################################
####################################################################################################
####################################################################################################
####################################################################################################
####################################################################################################