..................................................
#................................@@...............
#7...............................@@..............#
###..............................@@.............0#
##################################################
##################################################
##################################################