#############........................................................###############################
################...................................................@@@@@@@@@@@@@@###################
##################.................................................@@@@@@@@@.....###################
##################.................................................@@@@@@@@@.....###################
##################.7..............................................@@@@@@@@@@..0..###################
####################################################################################################
####################################################################################################
####################################################################################################
####################################################################################################
####################################################################################################
####################################################################################################
####################################################################################################
####################################################################################################