####################################################################################################
####################################################################################################
####################################################################################################
####################################################################################################
############@@@@@....................@@.....................................@@@.####################
##############@@@..................................................@@@@.........@@@@################
################@.......@@...........................@@@@.......................@@@@@@##############
###############@@@@@@@#########################################################@@@@@@@@#############
###############@@@@@@##########################################################@@###################
###################@@@@@.......@@...........................@@@@.................###################
####################@@.........................@@@@@@@...................@@@@...####################
#####################.7................@@.........0...........................@#####################
####################################################################################################
####################################################################################################
####################################################################################################
####################################################################################################