#############........................................................###############################
################...................................................#################################
#############.........................................................##############################
##################.................................................#################################
##################.0..............................................##################################
###################################...............................##################################
#############################################.................###...........########################
####################################################.....................7...#######################
##########################################################.................#########################
####################################################################################################
####################################################################################################
####################################################################################################
####################################################################################################