#############........................................................###############################
##################.................................................#################################
##################....................................................##############################
##################.................................................#################################
##################.0..............................................##################################
###################################............................#####################################
#############################################...............................########################
####################################################.....................7...#######################
##########################################################.................#########################
####################################################################################################
####################################################################################################
####################################################################################################
####################################################################################################
####################################################################################################
####################################################################################################
####################################################################################################
####################################################################################################